모든 맵
좌 파랑 우 빨강

용의 둥지
    건물
        2:  파랑팀 상단 요새
        12: 빨강팀 중단 요새
        1:  파랑팀 상단 성채
        4:  파랑팀 하단 요새
        8:  빨강팀 상단 요새
        6:  파랑팀 중단 요새
        5:  파랑팀 중단 성채
        10: 빨강팀 하단 요새

       
    용병
        1:  파랑팀 공성 캠프
        2:  파랑팀 투사 캠프
        3:  빨강팀 공성 캠프
        4:  빨강팀 투사 캠프
        5:  하단 투사 캠프 추정


하늘 사원
    건물
        6:  파랑팀 하단 요새
        4:  파랑팀 중단 요새
        2:  파랑팀 상단 요새
        8:  빨강팀 상단 요새
        5:  파랑팀 하단 성채
        10: 빨강팀 중단 요새
        3:  파랑팀 중단 성채
        7:  빨강팀 상단 성채
    용병
        1:  파랑팀 공성 캠프
        2:  파랑팀 투사 캠프
        3:  빨강팀 투사 캠프
        4:  빨강팀 공성 캠프
        5:  우두머리 캠프

볼스카야 공장
    건물
        10: 빨강팀 중단 요새
        8:  빨강팀 상단 요새
        9:  빨강팀 중단 성채
        7:  빨강팀 상단 성채
    용병
        1:  파랑팀 포탑 캠프
        2:  빨강팀 포탑 캠프
        3:  파랑팀 공성 캠프
        4:  빨강팀 공성 캠프
        5:  지원 캠프

파멸의 탑
    건물
        2:  파랑팀 중단 요새
        3:  파랑팀 하단 요새
        6:  빨강팀 하단 요새
    용병
        1:  파랑팀 공성 캠프
        2:  빨강팀 공성 캠프
        3:  상단 공성 캠프
        4:  우두머리 캠프

핵탄두 격전지  
    건물
        8:  빨강팀 상단 요새
        6:  파랑팀 하단 요새
        2:  파랑팀 상단 요새
        4:  파랑팀 중단 요새
        5:  파랑팀 하단 성채
        3:  파랑팀 중단 성채
    용병
        1:  파랑팀 공성 캠프
        2:  파랑팀 투사 캠프
        3:  빨강팀 공성 캠프
        4:  빨강팀 투사 캠프
        5:  상단 우두머리 캠프
        6:  하단 우두머리 캠프


공포의 정원
    건물
        2:  파랑팀 상단 요새
        4:  파랑팀 중단 요새
        6:  파랑팀 하단 요새
        3:  파랑팀 중단 성채
        5:  파랑팀 하단 성채
    용병
        1:  파랑팀 중단 공성 캠프
        2:  파랑팀 상단 공성 캠프
        3:  파랑팀 투사 캠프
        4:  빨강팀 중단 공성 캠프
        5:  빨강팀 하단 공성 캠프
        6:  빨강팀 투사 캠프

하나무라 사원
    건물
        4:  파랑팀 하단 요새
        2:  파랑팀 상단 요새
        3:  파랑팀 하단 성채
        1:  파랑팀 상단 성채
    용병
        1:  파랑팀 포탑 캠프
        2:  빨강팀 포탑 캠프
        3:  파랑팀 파수 캠프(겐지)
        4:  빨강팀 파수 캠프(겐지)
        5:  상단 정찰 캠프
        6:  하단 정찰 캠프(시야)

거미 여왕의 무덤
    건물
        6:  파랑팀 하단 요새
        4:  파랑팀 중단 요새
        2:  파랑팀 상단 요새
        1:  파랑팀 상단 성채
        3:  파랑팀 중단 성채
        5:  파랑팀 하단 성채
        10: 빨강팀 중단 요새
    용병
        1:  하단 공성 캠프
        2:  파랑팀 투사 캠프
        3:  빨강팀 투사 캠프
        4:  우두머리 캠프
블랙하트 항만
    건물
        10: 빨강팀 중단 요새
        8:  빨강팀 상단 요새
        12: 빨강팀 하단 요새
        4:  파랑팀 중단 요새
        2:  파랑팀 상단 요새
        6:  파랑팀 하단 요새
        3:  파랑팀 중단 성채
        1:  파랑팀 상단 성채
    용병
        1:  파랑팀 투사 캠프
        2:  파랑팀 공성 캠프
        3:  빨강팀 투사 캠프
        4:  빨강팀 공성 캠프
        5:  하단 투사 캠프
        6:  우두머리 캠프
        7:  파랑팀 중단 금화 캠프
        8:  파랑팀 상단 금화 캠프
        9:  빨강팀 중단 금화 캠프
        10: 빨강팀 상단 금화 캠프
영원의 전쟁터
    건물
        6:  빨강팀 상단 요새
        8:  빨강팀 하단 요새
        7:  빨강팀 하단 성채
    용병
        1:  상단 공성 캠프
        2:  파랑팀 투사 캠프
        3:  하단 공성 캠프
        4:  빨강팀 투사 캠프
저주받은 골짜기
    건물
        8:  빨강팀 상단 요새
        10: 빨강팀 중단 요새
        12: 빨강팀 하단 요새
        2:  파랑팀 상단 요새
        11: 빨강팀 하단 성채
        9:  빨강팀 중단 성채
        1:  파랑팀 상단 성채
        7:  빨강팀 상단 성채
    용병
        1:  파랑팀 공성 캠프
        2:  빨강팀 투사 캠프
        3:  빨강팀 공성 캠프
        4:  파랑팀 투사 캠프
        5:  파랑팀 우두머리 캠프
        6:  빨강팀 우두머리 캠프

브락시스 항전
    건물
        6:  빨강팀 상단 요새
        4:  파랑팀 하단 요새
        8:  빨강팀 하단 요새
        7:  빨강팀 하단 성채

    용병
        1:  파랑팀 공성 캠프
        2:  파랑팀 투사 캠프
        3:  빨강팀 공성 캠프
        4:  빨강팀 투사 캠프
        5:  우두머리 캠프

불지옥 신단
    건물
        2:  파랑팀 상단 요새
        6:  파랑팀 중단 요새
        5:  파랑팀 중단 성채
        4:  파랑팀 하단 요새
        3:  파랑팀 하단 성채
        1:  파랑팀 상단 성채
    용병
        1:  파랑팀 공성 캠프
        2:  파랑팀 투사 캠프
        3:  빨강팀 공성 캠프
        4:  빨강팀 투사 캠프
        5:  하단 공성 캠프

알터랙 고개
    건물
        12: 빨강팀 하단 요새
        8:  빨강팀 상단 요새
        10: 빨강팀 중단 요새
        6:  파랑팀 하단 요새
        2:  파랑팀 상단 요새
        7:  빨강팀 상단 성채
        4:  파랑팀 중단 요새
        3:  파랑팀 중단 성채
        5:  파랑팀 하단 성채

    용병
        1:  파랑팀 공성 캠프
        2:  상단 우두머리 캠프
        3:  빨강팀 공성 캠프
        4:  하단 우두머리 캠프

